Position	Classification
Account Manager	Accounting and Auditing
Accountant	Accounting and Auditing
Accountant	Accounting and Auditing
Accounting	Accounting and Auditing
Reporting Specialist	Accounting and Auditing
Accounting Assistant	Accounting and Auditing
Accounting Clerk	Accounting and Auditing
Tax Accountant	Accounting and Auditing
Accounting Specialist	Accounting and Auditing
Accounting Technician	Accounting and Auditing
Assurance Manager	Accounting and Auditing
Analyst	Accounting and Auditing
Assessor	Accounting and Auditing
Auditing	Accounting and Auditing
Auditor	Accounting and Auditing
Bookkeeper	Accounting and Auditing
Senior Consultant In Audit	Accounting and Auditing
Audit	Accounting and Auditing
Business Analyst	Accounting and Auditing
CFO	Accounting and Auditing
Controller	Accounting and Auditing
Account Manager	Accounting and Auditing
Estimator	Accounting and Auditing
Finance Manager	Accounting and Auditing
Financial Analyst	Accounting and Auditing
Fraud Analyst	Accounting and Auditing
Investment Analyst	Accounting and Auditing
Loan Officer	Accounting and Auditing
Project Accountant	Accounting and Auditing
Project Manager	Accounting and Auditing
Property Accountant	Accounting and Auditing
Quality Manager	Accounting and Auditing
Sales Manager	Accounting and Auditing
Staff Accountant	Accounting and Auditing
Tax Accountant	Accounting and Auditing
Tax Associate	Accounting and Auditing
Analyst	Banking and Insurance
Appraiser	Banking and Insurance
Auditor	Banking and Insurance
Bank Manager	Banking and Insurance
Bank Teller	Banking and Insurance
Banker	Banking and Insurance
Banking	Banking and Insurance
Bookkeeper	Banking and Insurance
Broker	Banking and Insurance
Budget Analyst	Banking and Insurance
Business Analyst	Banking and Insurance
CFO	Banking and Insurance
Claims Adjuster	Banking and Insurance
Claims Examiner	Banking and Insurance
Claims Specialist	Banking and Insurance
Coordinator	Banking and Insurance
Credit Analyst	Banking and Insurance
Equity Analyst	Banking and Insurance
Escrow Assistant	Banking and Insurance
Executive Assistant	Banking and Insurance
General Manager	Banking and Insurance
Insurance	Banking and Insurance
Insurance Agent	Banking and Insurance
Investment Advisor	Banking and Insurance
Investment Analyst	Banking and Insurance
Loan Officer	Banking and Insurance
Loan Originator	Banking and Insurance
Loan Processor	Banking and Insurance
Loss Prevention Manager	Banking and Insurance
Mortgage Closer	Banking and Insurance
Mortgage Loan Officer	Banking and Insurance
Mortgage Loan Originator	Banking and Insurance
Mortgage Processor	Banking and Insurance
Mortgage Underwriter	Banking and Insurance
Operations Manager	Banking and Insurance
Personal Banker	Banking and Insurance
Risk Manager	Banking and Insurance
Security Guard	Banking and Insurance
Supervisor	Banking and Insurance
Tax Preparer	Banking and Insurance
Teller	Banking and Insurance
Trader	Banking and Insurance
Trading Analyst	Banking and Insurance
Treasury	Banking and Insurance
Account Manager	Finance
Accountant	Finance
Finance Controller	Finance
Finance	Finance
Accounts Payable Clerk	Finance
Head Of Risk	Finance
Administrative Assistant	Finance
Analyst	Finance
FINANCE ASSISTANT	Finance
Billing Clerk	Finance
Billing Specialist	Finance
Bookkeeper	Finance
Transaction Advisor	Finance
Cashier	Finance
CFO	Finance
Collections Specialist	Finance
Compliance Specialist	Finance
Content Analyst	Finance
Controller	Finance
Debt Collector	Finance
Finance	Finance
Finance Analyst	Finance
Finance Manager	Finance
Financial	Finance
Financial Advisor	Finance
Financial Analyst	Finance
Financial Consultant	Finance
Financial Controller	Finance
Financial Counselor	Finance
Financial Manager	Finance
Financial Planner	Finance
Inventory Analyst	Finance
Investment Analyst	Finance
Payroll Assistant	Finance
Payroll Clerk	Finance
Payroll Specialist	Finance
Project Analyst	Finance
Purchasing Agent	Finance
Purchasing Assistant	Finance
Quantitative Analyst	Finance
Reporting Analyst	Finance
Risk Analyst	Finance
Statistical Analyst	Finance
Tax Consultant	Finance
Tax Analyst	Finance
Treasury Analyst	Finance
Underwriter	Finance
Agriculture	Agriculture and agribusiness
Analyst	Agriculture and agribusiness
Dispatcher	Agriculture and agribusiness
Farm	Agriculture and agribusiness
Farmer	Agriculture and agribusiness
Gardener	Agriculture and agribusiness
General Laborer	Agriculture and agribusiness
Janitor	Agriculture and agribusiness
Machinist	Agriculture and agribusiness
Mechanic	Agriculture and agribusiness
Packer	Agriculture and agribusiness
Picker	Agriculture and agribusiness
Quality Engineer	Agriculture and agribusiness
Sales Representative	Agriculture and agribusiness
Sorter	Agriculture and agribusiness
Stable Hand	Agriculture and agribusiness
Veterinary	Agriculture and agribusiness
Animal Care	Animal Care
Animal Technician	Animal Care
Caretaker	Animal Care
Farm Manager	Animal Care
Pest Control Technician	Animal Care
Veterinarian	Animal Care
Veterinary Technician	Animal Care
3d Designer	Architecture
Architect	Architecture
Architectural Designer	Architecture
Architecture	Architecture
Artist	Architecture
Designer	Architecture
Estimator	Architecture
Planner	Architecture
Assistant Superintendent	Construction
Building Inspector	Construction
Carpenter	Construction
Construction	Construction
Construction Foreman	Construction
Construction Helper	Construction
Construction Inspector	Construction
Construction Laborer	Construction
Construction Supervisor	Construction
Construction Worker	Construction
Coordinator	Construction
Crane Operator	Construction
Electrical Apprentice	Construction
Electrical Engineer	Construction
Electrical Helper	Construction
Electrical Inspector	Construction
Electrical Superintendent	Construction
Electrician	Construction
Electronics	Construction
Equipment Operator	Construction
Field Inspector	Construction
Fitter	Construction
Foreman	Construction
Handyman	Construction
Home Builder	Construction
Home Inspector	Construction
Industrial Electrician	Construction
Installer	Construction
Janitor	Construction
Journeyman Electrician	Construction
Locksmith	Construction
Machinist	Construction
Maintenance	Construction
Maintenance Electrician	Construction
Mason	Construction
Master Electrician	Construction
Operations Supervisor	Construction
Painter	Construction
Plumber	Construction
Process Engineer	Construction
Construction Worker	Construction
Quality Engineer	Construction
Repair	Construction
Sheet Metal Mechanic	Construction
Welder	Construction
Architect	Design and Creativity
Art Director	Design and Creativity
Artist	Design and Creativity
Coder	Design and Creativity
Content Producer	Design and Creativity
Creative	Design and Creativity
Design	Design and Creativity
Designer	Design and Creativity
Editor	Design and Creativity
Front End Developer	Design and Creativity
Graphic Artist	Design and Creativity
Graphic Designer	Design and Creativity
Illustrator	Design and Creativity
Industrial Designer	Design and Creativity
Interior Designer	Design and Creativity
Junior Designer	Design and Creativity
Production Designer	Design and Creativity
Tailor	Design and Creativity
Technical Writer	Design and Creativity
User Experience Designer	Design and Creativity
Video Producer	Design and Creativity
Visual Designer	Design and Creativity
Web Designer	Design and Creativity
Architect	Real Estate
Assistant Property Manager	Real Estate
Facility Manager	Real Estate
Handyman	Real Estate
Land Surveyor	Real Estate
Lawyer	Real Estate
Leasing Agent	Real Estate
Leasing Consultant	Real Estate
Property Manager	Real Estate
Real Estate	Real Estate
Real Estate Agent	Real Estate
Real Estate Analyst	Real Estate
Real Estate Appraiser	Real Estate
Real Estate Assistant	Real Estate
Realtor	Real Estate
Benefits Analyst	Human Resources
Recruiter	Human Resources
Benefits Coordinator	Human Resources
Benefits Specialist	Human Resources
Career Coach	Human Resources
Career Counselor	Human Resources
Director Of Human Resources	Human Resources
Executive Recruiter	Human Resources
HR Analyst	Human Resources
HR Assistant	Human Resources
Human Resources Specialist	Human Resources
HR Business Partner	Human Resources
HR Consultant	Human Resources
HR Coordinator	Human Resources
HR Director	Human Resources
HR Generalist	Human Resources
HR Manager	Human Resources
HR Recruiter	Human Resources
HR Specialist	Human Resources
Human Resource Development	Human Resources
Human Resources	Human Resources
Job Coach	Human Resources
Recruiter	Human Resources
Recruiting Coordinator	Human Resources
Recruitment Manager	Human Resources
Staffing Coordinator	Human Resources
Technical Recruiter	Human Resources
Account Manager	"Marketing, Advertising and PR"
Advertising	"Marketing, Advertising and PR"
Art Director	"Marketing, Advertising and PR"
Assistant Store Manager	"Marketing, Advertising and PR"
Brand Manager	"Marketing, Advertising and PR"
Business Analyst	"Marketing, Advertising and PR"
Business Development Director	"Marketing, Advertising and PR"
Campaign Manager	"Marketing, Advertising and PR"
Category Manager	"Marketing, Advertising and PR"
Channel Manager	"Marketing, Advertising and PR"
Chief Marketing Officer	"Marketing, Advertising and PR"
CMO	"Marketing, Advertising and PR"
Communications Manager	"Marketing, Advertising and PR"
Community Manager	"Marketing, Advertising and PR"
Content Editor	"Marketing, Advertising and PR"
Content Manager	"Marketing, Advertising and PR"
Content Specialist	"Marketing, Advertising and PR"
Coordinator	"Marketing, Advertising and PR"
Copywriter	"Marketing, Advertising and PR"
Creative Director	"Marketing, Advertising and PR"
Digital Marketing	"Marketing, Advertising and PR"
Director Of Marketing	"Marketing, Advertising and PR"
Editor	"Marketing, Advertising and PR"
Engagement Manager	"Marketing, Advertising and PR"
Event Manager	"Marketing, Advertising and PR"
Illustrator	"Marketing, Advertising and PR"
Interviewer	"Marketing, Advertising and PR"
Market Research Analyst	"Marketing, Advertising and PR"
Marketing	"Marketing, Advertising and PR"
Marketing Analyst	"Marketing, Advertising and PR"
Marketing Assistant	"Marketing, Advertising and PR"
Marketing Associate	"Marketing, Advertising and PR"
Marketing Coordinator	"Marketing, Advertising and PR"
Marketing Director	"Marketing, Advertising and PR"
Marketing Executive	"Marketing, Advertising and PR"
Marketing Manager	"Marketing, Advertising and PR"
Marketing Specialist	"Marketing, Advertising and PR"
Media Buyer	"Marketing, Advertising and PR"
Media Director	"Marketing, Advertising and PR"
Media Planner	"Marketing, Advertising and PR"
Merchandiser	"Marketing, Advertising and PR"
Office Manager	"Marketing, Advertising and PR"
Operations Manager	"Marketing, Advertising and PR"
Personal Assistant	"Marketing, Advertising and PR"
PR	"Marketing, Advertising and PR"
Product Marketing Manager	"Marketing, Advertising and PR"
Product Owner	"Marketing, Advertising and PR"
Regional Manager	"Marketing, Advertising and PR"
Social Media Manager	"Marketing, Advertising and PR"
Strategy Manager	"Marketing, Advertising and PR"
Territory Manager	"Marketing, Advertising and PR"
UI Designer	"Marketing, Advertising and PR"
Web Designer	"Marketing, Advertising and PR"
Writer	"Marketing, Advertising and PR"
Office Administrator	Administration
Account Manager	Administration
Admin	Administration
Administration	Administration
Administrative	Administration
Administrative Assistant	Administration
Administrative Coordinator	Administration
Administrator	Administration
Analyst	Administration
Assistant	Administration
Business Analyst	Administration
Cashier	Administration
Claims Processor	Administration
Claims Representative	Administration
Clerical Assistant	Administration
Clerk	Administration
Concierge	Administration
Contract Manager	Administration
Contract Specialist	Administration
Contracts Administrator	Administration
Coordinator	Administration
Customer Service Supervisor	Administration
Data Entry	Administration
Data Entry Clerk	Administration
Data Entry Operator	Administration
Dispatcher	Administration
Drafter	Administration
Event Coordinator	Administration
Executive Administrative Assistant	Administration
Executive Assistant	Administration
File Clerk	Administration
Financial Assistant	Administration
Front Desk Clerk	Administration
Hostess	Administration
Mail Clerk	Administration
Medical Administrative Assistant	Administration
Medical Secretary	Administration
Network Administrator	Administration
Office Administrator	Administration
Office Assistant	Administration
Office Clerk	Administration
Office Coordinator	Administration
Office Manager	Administration
Patient Coordinator	Administration
Payroll Administrator	Administration
Personal Assistant	Administration
Portfolio Manager	Administration
Project Assistant	Administration
Ramp Agent	Administration
Receptionist	Administration
Sales Representative	Administration
School Secretary	Administration
Secretary	Administration
Security Guard	Administration
Service Advisor	Administration
Sharepoint	Administration
Signing Agent	Administration
Surveyor	Administration
Switchboard Operator	Administration
System Administrator	Administration
Typist	Administration
Underwriting Assistant	Administration
Intern	Assistants
Accounting Assistant	Assistants
Administrative Assistant	Assistants
Aide	Assistants
Assistant	Assistants
Assistant Manager	Assistants
Assistant Teacher	Assistants
Certified Medical Assistant	Assistants
Certified Occupational Therapy Assistant	Assistants
Chiropractic Assistant	Assistants
CNA	Assistants
Dental Assistant	Assistants
Executive Assistant	Assistants
Graduate Assistant	Assistants
HR Assistant	Assistants
Lab Assistant	Assistants
Laboratory Assistant	Assistants
Legal Assistant	Assistants
Marketing Assistant	Assistants
Medical Administrative Assistant	Assistants
Medical Assistant	Assistants
Nursing Assistant	Assistants
Occupational Therapy Assistant	Assistants
Office Assistant	Assistants
Personal Assistant	Assistants
Physical Therapist Assistant	Assistants
Physician Assistant	Assistants
Production Assistant	Assistants
Program Assistant	Assistants
Real Estate Assistant	Assistants
Research Assistant	Assistants
Teacher Assistant	Assistants
Teaching Assistant	Assistants
Assistant Buyer	Business Specialists
Assistant Controller	Business Specialists
Business	Business Specialists
Business development	Business Specialists
Business Process Analyst	Business Specialists
Compensation Analyst	Business Specialists
Compliance Analyst	Business Specialists
Construction Estimator	Business Specialists
Contract Analyst	Business Specialists
Cost Estimator	Business Specialists
Electrical Estimator	Business Specialists
Employment Specialist	Business Specialists
Energy Analyst	Business Specialists
Entry Level Sales	Business Specialists
Environmental Manager	Business Specialists
Event Director	Business Specialists
Facilitator	Business Specialists
Field Investigator	Business Specialists
General Labor	Business Specialists
Healthcare Analyst	Business Specialists
Insurance Adjuster	Business Specialists
International Business	Business Specialists
Merchandise Planner	Business Specialists
Negotiator	Business Specialists
Operations Analyst	Business Specialists
Operations Coordinator	Business Specialists
Operations Specialist	Business Specialists
Planning	Business Specialists
Policy Analyst	Business Specialists
Pricing Analyst	Business Specialists
Product Analyst	Business Specialists
Product Specialist	Business Specialists
Program Coordinator	Business Specialists
Property Adjuster	Business Specialists
Quality Control	Business Specialists
Sales Trainer	Business Specialists
Services Manager	Business Specialists
Sports Business	Business Specialists
Strategic Planner	Business Specialists
Strategy	Business Specialists
Business Consultant	Consultancy
Consultant	Consultancy
Energy Consultant	Consultancy
Healthcare Consultant	Consultancy
Implementation Consultant	Consultancy
Marketing Consultant	Consultancy
Sap Consultant	Consultancy
Solutions Consultant	Consultancy
Strategic Consultant	Consultancy
Attorney	Legal
City Attorney	Legal
Clerk	Legal
Compliance Counsel	Legal
Content Manager	Legal
Contract Attorney	Legal
Corporate Attorney	Legal
Corporate Counsel	Legal
Corporate Lawyer	Legal
Corporate Paralegal	Legal
Counsel	Legal
Estate Planning Attorney	Legal
General Counsel	Legal
Healthcare Attorney	Legal
International Lawyer	Legal
Judge	Legal
Law Assistant	Legal
Law Clerk	Legal
Lawyer	Legal
Legal	Legal
Legal Analyst	Legal
Legal Assistant	Legal
Legal Clerk	Legal
Legal Consultant	Legal
Legal Counsel	Legal
Legal Secretary	Legal
Notary Public	Legal
Paralegal	Legal
Real Estate Attorney	Legal
Tax Attorney	Legal
Tax Counsel	Legal
Title Clerk	Legal
Administrative Assistant	"Secretarial, Clerical and Administrative Assistant"
Call Center	"Secretarial, Clerical and Administrative Assistant"
Call Center Representative	"Secretarial, Clerical and Administrative Assistant"
Clerical	"Secretarial, Clerical and Administrative Assistant"
Clerk	"Secretarial, Clerical and Administrative Assistant"
Concierge	"Secretarial, Clerical and Administrative Assistant"
Customer Service Manager	"Secretarial, Clerical and Administrative Assistant"
Customer Service Representative	"Secretarial, Clerical and Administrative Assistant"
Executive Assistant	"Secretarial, Clerical and Administrative Assistant"
Field Service Technician	"Secretarial, Clerical and Administrative Assistant"
Help Desk Analyst	"Secretarial, Clerical and Administrative Assistant"
Help Desk Technician	"Secretarial, Clerical and Administrative Assistant"
Hostess	"Secretarial, Clerical and Administrative Assistant"
HR Assistant	"Secretarial, Clerical and Administrative Assistant"
Legal Assistant	"Secretarial, Clerical and Administrative Assistant"
Personal Assistant	"Secretarial, Clerical and Administrative Assistant"
Receptionist	"Secretarial, Clerical and Administrative Assistant"
Secretarial	"Secretarial, Clerical and Administrative Assistant"
Secretary	"Secretarial, Clerical and Administrative Assistant"
Service Manager	"Secretarial, Clerical and Administrative Assistant"
Service Technician	"Secretarial, Clerical and Administrative Assistant"
Activities Assistant	Service
Activities Director	Service
Admissions Coordinator	Service
Admissions Counselor	Service
Admissions Representative	Service
Analyst	Service
Application Analyst	Service
Background Investigator	Service
Behavior Analyst	Service
Behavior Specialist	Service
Chaplain	Service
Child Care Worker	Service
Clinical Social Worker	Service
Clinical Supervisor	Service
College Counselor	Service
Community Health Worker	Service
Community Liaison	Service
Crisis Counselor	Service
Customer Service	Service
Customer Service Manager	Service
Customer Service Representative	Service
Desktop Support	Service
Desktop Support Technician	Service
Direct Support Professional	Service
Discharge Planner	Service
Education Consultant	Service
Education Director	Service
Education Specialist	Service
Field Engineer	Service
Field Service Engineer	Service
Field Service Technician	Service
Field Technician	Service
Fraud Investigator	Service
Health Coordinator	Service
Healthcare Social Worker	Service
Help Desk Analyst	Service
Help Desk Technician	Service
Hospice Social Worker	Service
Intake Coordinator	Service
Licensed Clinical Social Worker	Service
Life Coach	Service
Medical Social Worker	Service
Mentor	Service
Patient Service Representative	Service
Peer Support Specialist	Service
Private Investigator	Service
Program Assistant	Service
Public Health Analyst	Service
Referral Coordinator	Service
Relationship Manager	Service
Resident Assistant	Service
Residential Aide	Service
Residential Counselor	Service
Room Attendant	Service
Sales Engineer	Service
Sanitation Worker	Service
School Counselor	Service
School Social Worker	Service
Service Manager	Service
Service Technician	Service
Social Services	Service
Social Services Assistant	Service
Spa Manager	Service
Spiritual Director	Service
Student Advisor	Service
Substance Abuse Counselor	Service
Transportation Security Officer	Service
Union Organizer	Service
Union Representative	Service
Volunteer Coordinator	Service
Youth Counselor	Service
Adjunct Faculty	Education
Adjunct Instructor	Education
Adjunct Professor	Education
Art Assistant	Education
Assistant Teacher	Education
Clinical Coordinator	Education
Clinical Educator	Education
Clinical Instructor	Education
College Faculty	Education
Commercial Driver	Education
Computer Teacher	Education
Counselor	Education
Criminal Justice Instructor	Education
Driving Instructor	Education
Education	Education
Education Coordinator	Education
Educator	Education
Elementary School Teacher	Education
English Instructor	Education
English Professor	Education
English Teacher	Education
Faculty	Education
Graduate Assistant	Education
Guidance Counselor	Education
Head Of School	Education
Head Start Teacher	Education
Health Educator	Education
High School Teacher	Education
Instructional Assistant	Education
Instructional Designer	Education
Medical Billing And Coding	Education
Nurse Educator	Education
Nursing Faculty	Education
Paraprofessional	Education
Physical Education Teacher	Education
Professor	Education
Program Director	Education
Reading Teacher	Education
School	Education
School Aide	Education
School Principal	Education
Science Teacher	Education
Spanish Teacher	Education
Speech Therapist	Education
Substitute Teacher	Education
Supervisor	Education
Surveyor	Education
Teacher	Education
Teacher Aide	Education
Teacher Assistant	Education
Teaching Assistant	Education
Technical Writer	Education
Tutor	Education
University Administrator	Education
Account Coordinator	"Journalism, Publishing and Printing"
Anchor	"Journalism, Publishing and Printing"
Artist	"Journalism, Publishing and Printing"
Audio Engineer	"Journalism, Publishing and Printing"
Audio Technician	"Journalism, Publishing and Printing"
Auditor	"Journalism, Publishing and Printing"
Author	"Journalism, Publishing and Printing"
Board Operator	"Journalism, Publishing and Printing"
Cable Technician	"Journalism, Publishing and Printing"
Clerk	"Journalism, Publishing and Printing"
Communications	"Journalism, Publishing and Printing"
Communications Assistant	"Journalism, Publishing and Printing"
Communications Coordinator	"Journalism, Publishing and Printing"
Communications Director	"Journalism, Publishing and Printing"
Content Editor	"Journalism, Publishing and Printing"
Content Manager	"Journalism, Publishing and Printing"
Content Specialist	"Journalism, Publishing and Printing"
Content Writer	"Journalism, Publishing and Printing"
Copywriter	"Journalism, Publishing and Printing"
Digital Media	"Journalism, Publishing and Printing"
Documentation Specialist	"Journalism, Publishing and Printing"
Editor	"Journalism, Publishing and Printing"
Executive Assistant	"Journalism, Publishing and Printing"
Illustrator	"Journalism, Publishing and Printing"
Interpreter	"Journalism, Publishing and Printing"
Interviewer	"Journalism, Publishing and Printing"
Journalism	"Journalism, Publishing and Printing"
Journalist	"Journalism, Publishing and Printing"
Master Control Operator	"Journalism, Publishing and Printing"
Media	"Journalism, Publishing and Printing"
Media Planner	"Journalism, Publishing and Printing"
Media Production	"Journalism, Publishing and Printing"
Media Relations	"Journalism, Publishing and Printing"
Media Specialist	"Journalism, Publishing and Printing"
Medical Writer	"Journalism, Publishing and Printing"
News Producer	"Journalism, Publishing and Printing"
Newspaper	"Journalism, Publishing and Printing"
Printing	"Journalism, Publishing and Printing"
Publisher	"Journalism, Publishing and Printing"
Publishing	"Journalism, Publishing and Printing"
Reader	"Journalism, Publishing and Printing"
Reporter	"Journalism, Publishing and Printing"
Reviewer	"Journalism, Publishing and Printing"
Secretary	"Journalism, Publishing and Printing"
Social Media	"Journalism, Publishing and Printing"
Social Media Manager	"Journalism, Publishing and Printing"
Sound Designer	"Journalism, Publishing and Printing"
Sound Engineer	"Journalism, Publishing and Printing"
Sports Media	"Journalism, Publishing and Printing"
Staff Writer	"Journalism, Publishing and Printing"
Strategist	"Journalism, Publishing and Printing"
Technical Communicator	"Journalism, Publishing and Printing"
Transcriptionist	"Journalism, Publishing and Printing"
Video Coordinator	"Journalism, Publishing and Printing"
Video Editor	"Journalism, Publishing and Printing"
Writer	"Journalism, Publishing and Printing"
Corporate Trainer	"Training, Instructors and Translators"
Instructor	"Training, Instructors and Translators"
Library Director	"Training, Instructors and Translators"
Medical Assistant Instructor	"Training, Instructors and Translators"
Nursing Instructor	"Training, Instructors and Translators"
Psychology Instructor	"Training, Instructors and Translators"
Technical Trainer	"Training, Instructors and Translators"
Trainer	"Training, Instructors and Translators"
Training	"Training, Instructors and Translators"
Training Consultant	"Training, Instructors and Translators"
Training Coordinator	"Training, Instructors and Translators"
Training Manager	"Training, Instructors and Translators"
Training Specialist	"Training, Instructors and Translators"
Aerospace Engineer	Engineering
Application Engineer	Engineering
Applications Engineer	Engineering
Biomedical Engineer	Engineering
Bridge Engineer	Engineering
Building Engineer	Engineering
Chemical Engineer	Engineering
Civil Engineer	Engineering
Construction Engineer	Engineering
Controls Engineer	Engineering
Cyber Security Engineer	Engineering
Data Engineer	Engineering
Design Engineer	Engineering
Drilling Engineer	Engineering
Electronics Engineer	Engineering
Energy Engineer	Engineering
Engineer Scientist	Engineering
Engineering	Engineering
Engineering Assistant	Engineering
Engineering Consultant	Engineering
Engineering Intern	Engineering
Engineering Technician	Engineering
Entry Level Electrical Engineer	Engineering
Facilities Engineer	Engineering
Firmware Engineer	Engineering
Flight Engineer	Engineering
GEOtechnical Engineer	Engineering
Hardware Engineer	Engineering
Industrial Engineer	Engineering
Maintenance Engineer	Engineering
Marine Engineer	Engineering
Materials Engineer	Engineering
Network Engineer	Engineering
Networking Engineer	Engineering
Nuclear Engineer	Engineering
Oil And Gas Engineer	Engineering
Optical Engineer	Engineering
Packaging Engineer	Engineering
Pipeline Engineer	Engineering
Plant Engineer	Engineering
Product Development Engineer	Engineering
Product Engineer	Engineering
Project Engineer	Engineering
Reliability Engineer	Engineering
Research Engineer	Engineering
Robotics Engineer	Engineering
Safety Engineer	Engineering
Security Engineer	Engineering
Software Engineer	Engineering
Solar Engineer	Engineering
Storage Engineer	Engineering
Structural Engineer	Engineering
Support Engineer	Engineering
Systems Engineer	Engineering
Thermal Engineer	Engineering
Validation Engineer	Engineering
Water Resource Engineer	Engineering
Welding Engineer	Engineering
Assembler	Manufacturing and Mechanical
Autocad Drafter	Manufacturing and Mechanical
Automotive Technician	Manufacturing and Mechanical
Carpenter	Manufacturing and Mechanical
Chemical Operator	Manufacturing and Mechanical
Chemist	Manufacturing and Mechanical
Chief Engineer	Manufacturing and Mechanical
CNC Machinist	Manufacturing and Mechanical
Cnc Operator	Manufacturing and Mechanical
Computer Operator	Manufacturing and Mechanical
Copier Technician	Manufacturing and Mechanical
Craftsman	Manufacturing and Mechanical
Drafter	Manufacturing and Mechanical
Electrical Engineer	Manufacturing and Mechanical
Electrician	Manufacturing and Mechanical
Electronic Technician	Manufacturing and Mechanical
Electronics Technician	Manufacturing and Mechanical
Engineering	Manufacturing and Mechanical
Environmental Engineer	Manufacturing and Mechanical
Hvac Engineer	Manufacturing and Mechanical
Laser Operator	Manufacturing and Mechanical
Laundry Attendant	Manufacturing and Mechanical
Machine Operator	Manufacturing and Mechanical
Machinist	Manufacturing and Mechanical
Maintenance Planner	Manufacturing and Mechanical
Manual Machinist	Manufacturing and Mechanical
Manufacturing	Manufacturing and Mechanical
Manufacturing Engineer	Manufacturing and Mechanical
Manufacturing Supervisor	Manufacturing and Mechanical
Material Handler	Manufacturing and Mechanical
Mechanic	Manufacturing and Mechanical
Mechanical	Manufacturing and Mechanical
Mechanical Assembler	Manufacturing and Mechanical
Mechanical Engineer	Manufacturing and Mechanical
Miller	Manufacturing and Mechanical
Mixer	Manufacturing and Mechanical
Operator	Manufacturing and Mechanical
Painter	Manufacturing and Mechanical
Plant Operator	Manufacturing and Mechanical
Plumber	Manufacturing and Mechanical
Power Engineer	Manufacturing and Mechanical
Press Operator	Manufacturing and Mechanical
Process Engineer	Manufacturing and Mechanical
Process Operator	Manufacturing and Mechanical
Product Management	Manufacturing and Mechanical
Production Assistant	Manufacturing and Mechanical
Production Manager	Manufacturing and Mechanical
Production Operator	Manufacturing and Mechanical
Production Supervisor	Manufacturing and Mechanical
Production Worker	Manufacturing and Mechanical
Project Manager	Manufacturing and Mechanical
QA Analyst	Manufacturing and Mechanical
QA Engineer	Manufacturing and Mechanical
QA Tester	Manufacturing and Mechanical
Quality Control Inspector	Manufacturing and Mechanical
Quality Engineer	Manufacturing and Mechanical
Quality Inspector	Manufacturing and Mechanical
Quality Manager	Manufacturing and Mechanical
Radio Technician	Manufacturing and Mechanical
Research Assistant	Manufacturing and Mechanical
Research Associate	Manufacturing and Mechanical
Research Scientist	Manufacturing and Mechanical
Safety Manager	Manufacturing and Mechanical
Sewer	Manufacturing and Mechanical
Shop Foreman	Manufacturing and Mechanical
Skilled Trades	Manufacturing and Mechanical
Technical Director	Manufacturing and Mechanical
Technical Support Specialist	Manufacturing and Mechanical
Technician	Manufacturing and Mechanical
Test Technician	Manufacturing and Mechanical
Tower Technician	Manufacturing and Mechanical
Water Treatment Operator	Manufacturing and Mechanical
Welder	Manufacturing and Mechanical
Welding Supervisor	Manufacturing and Mechanical
Agronomist	Science
Biological Technician	Science
Biotechnology	Science
Chemical Technician	Science
Chemist	Science
Clinical Data Manager	Science
Clinical Laboratory Scientist	Science
Data Scientist	Science
Environmental Analyst	Science
Environmental Engineer	Science
Environmental Scientist	Science
Environmental Technician	Science
Food Scientist	Science
Forensics Analyst	Science
Hazmat Technician	Science
Laboratory Assistant	Science
Licensed Professional Counselor	Science
Materials Scientist	Science
Medical Laboratory Scientist	Science
Medical Science Liaison	Science
Medical Scientist	Science
Microbiologist	Science
Pharmacist	Science
Psychologist	Science
Quality Analyst	Science
Quality Assurance Analyst	Science
Research	Science
Research Analyst	Science
Research Assistant	Science
Research Fellow	Science
Research Scientist	Science
Research Technician	Science
Science	Science
Supply Chain Analyst	Science
Automation Technician	Technology
Avionics Technician	Technology
Cad Technician	Technology
Calibration Technician	Technology
Computer Aided Design	Technology
Electrical Technician	Technology
Electro Mechanical Technician	Technology
Electronic	Technology
Engineering	Technology
Environmental Consultant	Technology
Environmental Specialist	Technology
Independent Contractor	Technology
Laboratory Technician	Technology
Maintenance Technician	Technology
Manufacturing Technician	Technology
Mechanical Technician	Technology
PLC Technician	Technology
Printer Technician	Technology
Process Technician	Technology
Quality Technician	Technology
Safety Consultant	Technology
Safety Coordinator	Technology
Scientist	Technology
Structural Designer	Technology
Technical	Technology
Technical Analyst	Technology
Technical Consultant	Technology
Technical Designer	Technology
Technical Manager	Technology
Technology	Technology
Technology Consultant	Technology
Automotive Service Advisor	Telecommunication
Big Data Engineer	Telecommunication
Biomedical Equipment Technician	Telecommunication
Call Center Manager	Telecommunication
Central Service Technician	Telecommunication
Communications Specialist	Telecommunication
Customer Service Agent	Telecommunication
Customer Service Manager	Telecommunication
Customer Service Representative	Telecommunication
Devops	Telecommunication
Devops Engineer	Telecommunication
Dispatcher	Telecommunication
Driver	Telecommunication
Electrical Engineer	Telecommunication
Electrician	Telecommunication
Electronic Engineer	Telecommunication
Lineman	Telecommunication
Maintenance Mechanic	Telecommunication
Mechanic	Telecommunication
Mobile Developer	Telecommunication
Network Administrator	Telecommunication
Network Engineer	Telecommunication
Power Engineer	Telecommunication
Process Engineer	Telecommunication
Project Manager	Telecommunication
Quality Manager	Telecommunication
Refrigeration Technician	Telecommunication
Regional Manager	Telecommunication
Repair Technician	Telecommunication
Sql Developer	Telecommunication
Systems Administrator	Telecommunication
Systems Analyst	Telecommunication
Technician	Telecommunication
Telecommunications	Telecommunication
Telecommunications Technician	Telecommunication
Tester	Telecommunication
Activity Director	Healthcare
Anesthesia Technician	Healthcare
Anesthesiologist	Healthcare
Behavioral Health Technician	Healthcare
Cardiologist	Healthcare
Cardiovascular Technologist	Healthcare
Care Coordinator	Healthcare
Caregiver	Healthcare
Case Manager	Healthcare
Certified Medical Assistant	Healthcare
Certified Occupational Therapy Assistant	Healthcare
Chiropractic Assistant	Healthcare
CNA	Healthcare
Coordinator	Healthcare
Dental Assistant	Healthcare
Dental Hygienist	Healthcare
Dentist	Healthcare
Dialysis Technician	Healthcare
Dietary Aide	Healthcare
Dietitian	Healthcare
Doctor	Healthcare
Emergency Department Technician	Healthcare
Emergency Room Technician	Healthcare
Health Coach	Healthcare
Healthcare	Healthcare
Home Health Aide	Healthcare
Hospice	Healthcare
Hospital	Healthcare
Hospitalist	Healthcare
Instrument Technician	Healthcare
LPN	Healthcare
LVN	Healthcare
Massage Therapist	Healthcare
Medical	Healthcare
Medical Assistant	Healthcare
Nurse	Healthcare
Nurse Practitioner	Healthcare
Nursing	Healthcare
Nursing Assistant	Healthcare
Nutritionist	Healthcare
Occupational Therapist	Healthcare
Occupational Therapy Assistant	Healthcare
Paramedic	Healthcare
Pathology Assistant	Healthcare
Patient Care Assistant	Healthcare
Patient Care Coordinator	Healthcare
Patient Care Technician	Healthcare
Patient Sitter	Healthcare
Pharmacist	Healthcare
Pharmacy Clerk	Healthcare
Phlebotomist	Healthcare
Phlebotomy Technician	Healthcare
Physical Therapist	Healthcare
Physical Therapist Assistant	Healthcare
Physical Therapy Aide	Healthcare
Physical Therapy Technician	Healthcare
Physician Assistant	Healthcare
Psychiatric Technician	Healthcare
Radiology Technician	Healthcare
Registrar	Healthcare
Respiratory Therapist	Healthcare
RN	Healthcare
Social Worker	Healthcare
Sonographer	Healthcare
Specimen Processor	Healthcare
Speech Language Pathologist	Healthcare
Sterile Processing Technician	Healthcare
Surgery Assistant	Healthcare
Surgical Assistant	Healthcare
Surgical Technologist	Healthcare
Ultrasound Technician	Healthcare
Unit Clerk	Healthcare
Unit Secretary	Healthcare
Certified Medical Assistant	Medical
Chief Medical Officer	Medical
Clinical Assistant	Medical
Clinical Dietitian	Medical
Clinical Documentation Specialist	Medical
Clinical Liaison	Medical
Clinical Specialist	Medical
Clinical Technician	Medical
Emergency Medical Technician	Medical
Healthcare	Medical
Medical	Medical
Medical Administrative Assistant	Medical
Medical Assistant	Medical
Medical Biller	Medical
Medical Billing And Coding	Medical
Medical Clerk	Medical
Medical Coder	Medical
Medical Coding Specialist	Medical
Medical Consultant	Medical
Medical Director	Medical
Medical Laboratory Scientist	Medical
Medical Liaison	Medical
Medical Office Assistant	Medical
Medical Office Specialist	Medical
Medical Receptionist	Medical
Medical Records Clerk	Medical
Medical Records Technician	Medical
Medical Representative	Medical
Medical Sales Representative	Medical
Medical Science Liaison	Medical
Medical Secretary	Medical
Medical Social Worker	Medical
Medical Staff Coordinator	Medical
Medical Technician	Medical
Medical Technologist	Medical
Medical Transcriptionist	Medical
Medical Writer	Medical
Mental Health Counselor	Medical
Mental Health Professional	Medical
Mental Health Specialist	Medical
Mental Health Technician	Medical
Mental Health Therapist	Medical
Mental Health Worker	Medical
Remote Medical Coder	Medical
Analyst	Medicine and Pharmaceutical
Analytical Chemist	Medicine and Pharmaceutical
Biotechnology	Medicine and Pharmaceutical
Chemist	Medicine and Pharmaceutical
Lab Assistant	Medicine and Pharmaceutical
Lab Technician	Medicine and Pharmaceutical
Medical	Medicine and Pharmaceutical
Medical Assistant	Medicine and Pharmaceutical
Medicine	Medicine and Pharmaceutical
Microbiologist	Medicine and Pharmaceutical
Nurse	Medicine and Pharmaceutical
Pharmaceutical	Medicine and Pharmaceutical
Pharmaceutical Sales Representative	Medicine and Pharmaceutical
Pharmacist	Medicine and Pharmaceutical
Pharmacy Technician	Medicine and Pharmaceutical
Psychiatrist	Medicine and Pharmaceutical
Psychologist	Medicine and Pharmaceutical
Radiologist	Medicine and Pharmaceutical
Social Worker	Medicine and Pharmaceutical
Therapist	Medicine and Pharmaceutical
Vet	Medicine and Pharmaceutical
Veterinary	Medicine and Pharmaceutical
Clinical Nurse Leader	Nursing
CNA	Nursing
Community Health Nurse	Nursing
Dialysis Nurse	Nursing
Director Of Nursing	Nursing
Endoscopy Nurse	Nursing
Graduate Nurse	Nursing
Home Health Nurse	Nursing
Hospice Nurse	Nursing
Infusion Nurse	Nursing
Labor And Delivery Nurse	Nursing
LPN	Nursing
LVN	Nursing
Nurse	Nursing
Nurse Aide	Nursing
Nurse Assistant	Nursing
Nurse Consultant	Nursing
Nurse Practitioner	Nursing
Nurse Supervisor	Nursing
Nurse Technician	Nursing
Nursery Nurse	Nursing
Nursing	Nursing
Nursing Assistant	Nursing
Nursing Supervisor	Nursing
Occupational Health Nurse	Nursing
Office Nurse	Nursing
Oncology Nurse	Nursing
Research Nurse	Nursing
RN	Nursing
School Nurse	Nursing
Student Nurse	Nursing
Triage Nurse	Nursing
Utilization Review Nurse	Nursing
Wellness Nurse	Nursing
Wound Care Nurse	Nursing
.Net Developer	Developers
Android Developer	Developers
Angular Developer	Developers
Application Developer	Developers
Business Intelligence Developer	Developers
C# Developer	Developers
C++ Developer	Developers
Content Developer	Developers
Database Developer	Developers
Developer	Developers
ETL Developer	Developers
Front End Developer	Developers
Full Stack Developer	Developers
Game Developer	Developers
HTML Developer	Developers
Informatica Developer	Developers
iOS Developer	Developers
Java Developer	Developers
Javascript Developer	Developers
Junior Developer	Developers
Mainframe Developer	Developers
Mobile Developer	Developers
Oracle Developer	Developers
Power Bi Developers	Developers
PHP Developer	Developers
Python Developer	Developers
Remote Developer	Developers
Ruby Developer	Developers
Salesforce Developer	Developers
Sharepoint Developer	Developers
Software Developer	Developers
SQL Developer	Developers
Sql Developer	Developers
UI Developer	Developers
Web Developer	Developers
"
DevOps specialist
"	Information Technology and Computer
"
Big Data Visualization Specialist
"	Information Technology and Computer
.Net Technical Lead	Information Technology and Computer
.Net Developer	Information Technology and Computer
Agile Coach	Information Technology and Computer
Android Developer	Information Technology and Computer
Automation Engineer	Information Technology and Computer
Big Data Engineer	Information Technology and Computer
Business Intelligence Analyst	Information Technology and Computer
Integration Specialist	Information Technology and Computer
CIO	Information Technology and Computer
Clinical Analyst	Information Technology and Computer
Community Manager	Information Technology and Computer
Functional Consultant	Information Technology and Computer
Computer	Information Technology and Computer
Computer Analyst	Information Technology and Computer
Computer Hardware	Information Technology and Computer
SAP Functional Analyst	Information Technology and Computer
Computer Scientist	Information Technology and Computer
Computer Technician	Information Technology and Computer
CTO	Information Technology and Computer
Cyber Security Analyst	Information Technology and Computer
Data Analyst	Information Technology and Computer
Data Architect	Information Technology and Computer
Data Center Technician	Information Technology and Computer
Data Entry	Information Technology and Computer
Data Manager	Information Technology and Computer
Data Modeler	Information Technology and Computer
Data Scientist	Information Technology and Computer
Database Administrator	Information Technology and Computer
Database Analyst	Information Technology and Computer
Programmer 	Information Technology and Computer
Developer	Information Technology and Computer
Devops	Information Technology and Computer
Devops Engineer	Information Technology and Computer
Support Specialist	Information Technology and Computer
Document Specialist	Information Technology and Computer
Engineer Technician	Information Technology and Computer
Enterprise Architect	Information Technology and Computer
Full Stack Developer	Information Technology and Computer
Game Developer	Information Technology and Computer
Information Security Analyst	Information Technology and Computer
Interaction Designer	Information Technology and Computer
QA Lead	Information Technology and Computer
IT	Information Technology and Computer
IT Director	Information Technology and Computer
IT Engineer	Information Technology and Computer
IT Manager	Information Technology and Computer
IT Project Manager	Information Technology and Computer
IT Specialist	Information Technology and Computer
IT Professional	Information Technology and Computer
Java Developer	Information Technology and Computer
Java Programmer	Information Technology and Computer
Junior Developer	Information Technology and Computer
Linux Administrator	Information Technology and Computer
Network Administrator	Information Technology and Computer
Network Analyst	Information Technology and Computer
Network Architect	Information Technology and Computer
Network Engineer	Information Technology and Computer
Network Specialist	Information Technology and Computer
Network Technician	Information Technology and Computer
Operations Manager	Information Technology and Computer
PC Technician	Information Technology and Computer
Programmer	Information Technology and Computer
Programmer Analyst	Information Technology and Computer
Python Developer	Information Technology and Computer
Quality Assurance (QA) Engineer	Information Technology and Computer
Quality Assurance (QA) Manager	Information Technology and Computer
Release Manager	Information Technology and Computer
Remote Developer	Information Technology and Computer
Salesforce Developer	Information Technology and Computer
Scrum Master	Information Technology and Computer
Sharepoint Administrator	Information Technology and Computer
Software Architect	Information Technology and Computer
Software Developer	Information Technology and Computer
Software Engineer	Information Technology and Computer
Software Tester	Information Technology and Computer
Solutions Architect	Information Technology and Computer
SQL Developer	Information Technology and Computer
System Administrator	Information Technology and Computer
System Analyst	Information Technology and Computer
System Engineer	Information Technology and Computer
Test Engineer	Information Technology and Computer
Tester	Information Technology and Computer
Content Editor	Internet
Content Manager	Internet
Data Analyst	Internet
Data Scientist	Internet
Digital Marketing	Internet
Internet	Internet
iOS Developer	Internet
iOS Engineer	Internet
Javascript Developer	Internet
Online Marketing	Internet
PHP Developer	Internet
SEO	Internet
Social Media Coordinator	Internet
Social Media Manager	Internet
Social Media Specialist	Internet
UI Designer	Internet
UI Developer	Internet
UX Designer	Internet
Web Designer	Internet
Web Developer	Internet
Web Development	Internet
Account Manager	Middle Management
Advertising Manager	Middle Management
Ambassador	Middle Management
Analytics Manager	Middle Management
Apartment Manager	Middle Management
Apprentice	Middle Management
Asset Manager	Middle Management
Assistant Director	Middle Management
Assistant Manager	Middle Management
Assistant Principal	Middle Management
Benefits Administrator	Middle Management
Benefits Manager	Middle Management
Branch Manager	Middle Management
Business Office Manager	Middle Management
Call Center Supervisor	Middle Management
Care Manager	Middle Management
Catering Manager	Middle Management
Chef	Middle Management
Claims Manager	Middle Management
Clinical Research Associate	Middle Management
Clinical Research Coordinator	Middle Management
Compensation Manager	Middle Management
Compliance Manager	Middle Management
Compliance Officer	Middle Management
Construction Manager	Middle Management
Construction Superintendent	Middle Management
Credit Manager	Middle Management
Design Manager	Middle Management
Development Manager	Middle Management
Dietary Manager	Middle Management
District Manager	Middle Management
Engineering Manager	Middle Management
Executive Chef	Middle Management
Facilities Manager	Middle Management
Financial Manager	Middle Management
Fitness Manager	Middle Management
Fleet Manager	Middle Management
Food Service Manager	Middle Management
General Manager	Middle Management
Grants Manager	Middle Management
House Manager	Middle Management
HR Manager	Middle Management
Information Systems Manager	Middle Management
Inventor	Middle Management
Inventory Manager	Middle Management
IT	Middle Management
Kitchen Manager	Middle Management
Maintenance Manager	Middle Management
Management	Middle Management
Manager	Middle Management
Manufacturing Manager	Middle Management
Marketing Manager	Middle Management
Nurse Manager	Middle Management
Nursing Home Administrator	Middle Management
Office Manager	Middle Management
Operations Manager	Middle Management
Payroll Manager	Middle Management
Pharmacy Manager	Middle Management
Plant Manager	Middle Management
Practice Administrator	Middle Management
Practice Manager	Middle Management
Product Manager	Middle Management
Product Owner	Middle Management
Program Manager	Middle Management
Project Coordinator	Middle Management
Project Manager	Middle Management
Proposal Manager	Middle Management
Purchasing Manager	Middle Management
Quality Assurance	Middle Management
Quality Manager	Middle Management
Regional Manager	Middle Management
Research Coordinator	Middle Management
Resident Manager	Middle Management
Resort Manager	Middle Management
Restaurant Manager	Middle Management
Sales Manager	Middle Management
Software Development Manager	Middle Management
Superintendent	Middle Management
Supervisor	Middle Management
Supply Chain Manager	Middle Management
Tax Director	Middle Management
Tax Manager	Middle Management
Team Leader	Middle Management
Technology Manager	Middle Management
Territory Manager	Middle Management
Treasury Manager	Middle Management
Trust Officer	Middle Management
Workforce Manager	Middle Management
Call Center Director	"Upper, Senior management and C Level"
CEO	"Upper, Senior management and C Level"
CFO	"Upper, Senior management and C Level"
Chief Data Officer	"Upper, Senior management and C Level"
Chief Digital Officer	"Upper, Senior management and C Level"
Chief Engineer	"Upper, Senior management and C Level"
Chief Investment Officer	"Upper, Senior management and C Level"
Chief Medical Officer	"Upper, Senior management and C Level"
Chief Nursing Officer	"Upper, Senior management and C Level"
Chief Risk Officer	"Upper, Senior management and C Level"
Chief Strategy Officer	"Upper, Senior management and C Level"
Child Care Director	"Upper, Senior management and C Level"
CIO	"Upper, Senior management and C Level"
Clinical Director	"Upper, Senior management and C Level"
CMO	"Upper, Senior management and C Level"
College President	"Upper, Senior management and C Level"
Compliance Director	"Upper, Senior management and C Level"
COO	"Upper, Senior management and C Level"
CRO	"Upper, Senior management and C Level"
CTO	"Upper, Senior management and C Level"
Director	"Upper, Senior management and C Level"
Director Of Admissions	"Upper, Senior management and C Level"
Director Of Education	"Upper, Senior management and C Level"
Director Of Engineering	"Upper, Senior management and C Level"
Director Of Finance	"Upper, Senior management and C Level"
Director Of Operations	"Upper, Senior management and C Level"
Director Of Pharmacy	"Upper, Senior management and C Level"
Director Of Security	"Upper, Senior management and C Level"
Director Of Technology	"Upper, Senior management and C Level"
Executive	"Upper, Senior management and C Level"
Executive Director	"Upper, Senior management and C Level"
Food Service Director	"Upper, Senior management and C Level"
General Counsel	"Upper, Senior management and C Level"
HR Director	"Upper, Senior management and C Level"
IT Director	"Upper, Senior management and C Level"
Laboratory Director	"Upper, Senior management and C Level"
Maintenance Director	"Upper, Senior management and C Level"
Marketing Director	"Upper, Senior management and C Level"
Medical Director	"Upper, Senior management and C Level"
President	"Upper, Senior management and C Level"
Quality Director	"Upper, Senior management and C Level"
Safety Director	"Upper, Senior management and C Level"
Sales Director	"Upper, Senior management and C Level"
Senior Management	"Upper, Senior management and C Level"
Social Services Director	"Upper, Senior management and C Level"
Supply Chain Director	"Upper, Senior management and C Level"
Technical Director	"Upper, Senior management and C Level"
Vice President	"Upper, Senior management and C Level"
Vice President Of Operations	"Upper, Senior management and C Level"
Game Presenter	Other
Entry Level	Other
Full Time	Other
Shuffler	Other
Graduate	Other
Non Profit	Other
Part Time	Other
Remote	Other
Seasonal	Other
Student	Other
Veterans	Other
Work From Home	Other
Armed Security Officer	"Security, Military and Government"
Army National Guard	"Security, Military and Government"
Army Officer	"Security, Military and Government"
Chief	"Security, Military and Government"
Chief Of Staff	"Security, Military and Government"
Correctional Officer	"Security, Military and Government"
Corrections Officer	"Security, Military and Government"
Court Officer	"Security, Military and Government"
Detective	"Security, Military and Government"
Detention Officer	"Security, Military and Government"
Electric	"Security, Military and Government"
Facility Security Officer	"Security, Military and Government"
Fire Chief	"Security, Military and Government"
Fire Inspector	"Security, Military and Government"
Government	"Security, Military and Government"
Inspector	"Security, Military and Government"
Intelligence Analyst	"Security, Military and Government"
Major	"Security, Military and Government"
Military	"Security, Military and Government"
Military Officer	"Security, Military and Government"
Patrol Officer	"Security, Military and Government"
Peace Officer	"Security, Military and Government"
Police Officer	"Security, Military and Government"
Polygraph	"Security, Military and Government"
Porter	"Security, Military and Government"
Public Safety Officer	"Security, Military and Government"
Safety Inspector	"Security, Military and Government"
Safety Officer	"Security, Military and Government"
Safety Specialist	"Security, Military and Government"
Safety Technician	"Security, Military and Government"
Security	"Security, Military and Government"
Security Administrator	"Security, Military and Government"
Security Analyst	"Security, Military and Government"
Security Architect	"Security, Military and Government"
Security Consultant	"Security, Military and Government"
Security Director	"Security, Military and Government"
Security Engineer	"Security, Military and Government"
Security guard	"Security, Military and Government"
Security Manager	"Security, Military and Government"
Security officer	"Security, Military and Government"
Security Specialist	"Security, Military and Government"
Security Supervisor	"Security, Military and Government"
Special Agent	"Security, Military and Government"
Superintendent	"Security, Military and Government"
Surveillance	"Security, Military and Government"
Activities Coordinator	"Beauty, Fitness and Sports"
Athletic Trainer	"Beauty, Fitness and Sports"
Beauty	"Beauty, Fitness and Sports"
Beauty Consultant	"Beauty, Fitness and Sports"
Child Care Assistant	"Beauty, Fitness and Sports"
Child Life Specialist	"Beauty, Fitness and Sports"
Coach	"Beauty, Fitness and Sports"
Fitness	"Beauty, Fitness and Sports"
Fitness Director	"Beauty, Fitness and Sports"
Fitness Specialist	"Beauty, Fitness and Sports"
Fitness Trainer	"Beauty, Fitness and Sports"
Groundskeeper	"Beauty, Fitness and Sports"
Homemaker	"Beauty, Fitness and Sports"
Image Consultant	"Beauty, Fitness and Sports"
Market Research Analyst	"Beauty, Fitness and Sports"
Massage Therapist	"Beauty, Fitness and Sports"
Merchandiser	"Beauty, Fitness and Sports"
Methodist	"Beauty, Fitness and Sports"
Model	"Beauty, Fitness and Sports"
Personal Care Aide	"Beauty, Fitness and Sports"
Personal Care Assistant	"Beauty, Fitness and Sports"
Personal Care Attendant	"Beauty, Fitness and Sports"
Personal Trainer	"Beauty, Fitness and Sports"
Physical Therapist	"Beauty, Fitness and Sports"
Promoter	"Beauty, Fitness and Sports"
Resident Advisor	"Beauty, Fitness and Sports"
Scout	"Beauty, Fitness and Sports"
Sitter	"Beauty, Fitness and Sports"
Sports	"Beauty, Fitness and Sports"
Sports Agent	"Beauty, Fitness and Sports"
Strength And Conditioning Coach	"Beauty, Fitness and Sports"
Stylist	"Beauty, Fitness and Sports"
Utility Worker	"Beauty, Fitness and Sports"
Valet	"Beauty, Fitness and Sports"
Wellness Coordinator	"Beauty, Fitness and Sports"
Yoga	"Beauty, Fitness and Sports"
Art Director	"Culture, Music and Entertainment"
Artist	"Culture, Music and Entertainment"
Assistant Coach	"Culture, Music and Entertainment"
Conductor	"Culture, Music and Entertainment"
Copywriter	"Culture, Music and Entertainment"
Creative Director	"Culture, Music and Entertainment"
Designer	"Culture, Music and Entertainment"
DJ	"Culture, Music and Entertainment"
Entertainment	"Culture, Music and Entertainment"
Event Manager	"Culture, Music and Entertainment"
Music	"Culture, Music and Entertainment"
Producer	"Culture, Music and Entertainment"
Production Coordinator	"Culture, Music and Entertainment"
Stage Manager	"Culture, Music and Entertainment"
Bar manager	"Hotels, Hospitality and Tourism"
Barista	"Hotels, Hospitality and Tourism"
Barman	"Hotels, Hospitality and Tourism"
Bartender	"Hotels, Hospitality and Tourism"
Booking Agent	"Hotels, Hospitality and Tourism"
Butcher	"Hotels, Hospitality and Tourism"
Butler	"Hotels, Hospitality and Tourism"
Concierge	"Hotels, Hospitality and Tourism"
Cook	"Hotels, Hospitality and Tourism"
Custodian	"Hotels, Hospitality and Tourism"
Director Of Housekeeping	"Hotels, Hospitality and Tourism"
Event Manager	"Hotels, Hospitality and Tourism"
Event Planner	"Hotels, Hospitality and Tourism"
Guide	"Hotels, Hospitality and Tourism"
Handyman	"Hotels, Hospitality and Tourism"
Hospitality	"Hotels, Hospitality and Tourism"
Hostess	"Hotels, Hospitality and Tourism"
Hotel	"Hotels, Hospitality and Tourism"
Housekeeper	"Hotels, Hospitality and Tourism"
Housekeeping Manager	"Hotels, Hospitality and Tourism"
Housekeeping Supervisor	"Hotels, Hospitality and Tourism"
Maintenance Supervisor	"Hotels, Hospitality and Tourism"
Recreation Assistant	"Hotels, Hospitality and Tourism"
Restaurant	"Hotels, Hospitality and Tourism"
Restaurant manager	"Hotels, Hospitality and Tourism"
Steward	"Hotels, Hospitality and Tourism"
Travel Agent	"Hotels, Hospitality and Tourism"
Travel Consultant	"Hotels, Hospitality and Tourism"
Travel manager	"Hotels, Hospitality and Tourism"
Trimmer	"Hotels, Hospitality and Tourism"
Bakery Manager	Restaurant
Bar	Restaurant
Bar Back	Restaurant
Barista	Restaurant
Bartender	Restaurant
Busser	Restaurant
Cafe	Restaurant
Cashier	Restaurant
Dishwasher	Restaurant
Food And Beverage Manager	Restaurant
Food Runner	Restaurant
Food Server	Restaurant
Food Service	Restaurant
Food Service Worker	Restaurant
Greeter	Restaurant
Line Cook	Restaurant
Meat Cutter	Restaurant
Pastry Cook	Restaurant
Prep Cook	Restaurant
Restaurant	Restaurant
Restaurant Hostess	Restaurant
Restaurant manager	Restaurant
Sous Chef	Restaurant
Waiter	Restaurant
Waitress	Restaurant
Baker	Retail
Barista	Retail
Buyer	Retail
Carpenter	Retail
Cashier	Retail
Cook	Retail
Merchandiser	Retail
Office Manager	Retail
Regional Manager	Retail
Retail	Retail
Retail Consultant	Retail
Retail Merchandiser	Retail
Retail Sales	Retail
Retail Sales Associate	Retail
Retail Store Manager	Retail
Sales Analyst	Retail
Sales Assistant	Retail
Sales Associate	Retail
Sales Director	Retail
Sales Manager	Retail
Sales Representative	Retail
Security Guard	Retail
Store	Retail
Store Manager	Retail
Supervisor	Retail
Territory Manager	Retail
Waiter	Retail
Account Executive	Sales and Procurement
Account Manager	Sales and Procurement
Account Representative	Sales and Procurement
Appointment Setter	Sales and Procurement
Area Manager	Sales and Procurement
Assistant Director	Sales and Procurement
Brand Ambassador	Sales and Procurement
Business Analyst	Sales and Procurement
Business Development Manager	Sales and Procurement
Buyer	Sales and Procurement
Campus Representative	Sales and Procurement
Cashier	Sales and Procurement
Clerk	Sales and Procurement
CMO (Chief Marketing Manager)	Sales and Procurement
Customer Service	Sales and Procurement
Customer Service Manager	Sales and Procurement
Customer Service Representative	Sales and Procurement
Demonstrator	Sales and Procurement
Director Of Sales	Sales and Procurement
Event Manager	Sales and Procurement
Executive Assistant	Sales and Procurement
Inside Sales Representative	Sales and Procurement
Insurance Manager	Sales and Procurement
Insurance Sales Agent	Sales and Procurement
Medical Sales Representative	Sales and Procurement
Merchandiser	Sales and Procurement
Merchandising Manager	Sales and Procurement
Office Manager	Sales and Procurement
Outside Sales Representative	Sales and Procurement
Parts Manager	Sales and Procurement
Procurement	Sales and Procurement
Procurement Director	Sales and Procurement
Procurement Manager	Sales and Procurement
Procurement Specialist	Sales and Procurement
Promotional Model	Sales and Procurement
Purchasing Manager	Sales and Procurement
Regional Manager	Sales and Procurement
Regional Sales Manager	Sales and Procurement
Retail Manager	Sales and Procurement
Sales	Sales and Procurement
Sales Analyst	Sales and Procurement
Sales Assistant	Sales and Procurement
Sales Associate	Sales and Procurement
Sales Consultant	Sales and Procurement
Sales Coordinator	Sales and Procurement
Sales Director	Sales and Procurement
Sales Engineer	Sales and Procurement
Sales Executive	Sales and Procurement
Sales Manager	Sales and Procurement
Sales Representative	Sales and Procurement
Salesman	Sales and Procurement
Territory Manager	Sales and Procurement
Trade	Sales and Procurement
Courier	Logistics and Warehouse
Delivery Driver	Logistics and Warehouse
Dispatcher	Logistics and Warehouse
Distribution	Logistics and Warehouse
Distribution Manager	Logistics and Warehouse
Driver	Logistics and Warehouse
Forklift Operator	Logistics and Warehouse
Inventory	Logistics and Warehouse
Loader	Logistics and Warehouse
Logistics	Logistics and Warehouse
Logistics Analyst	Logistics and Warehouse
Logistics Coordinator	Logistics and Warehouse
Logistics Manager	Logistics and Warehouse
Transport Manager	Logistics and Warehouse
Logistics Specialist	Logistics and Warehouse
Machinist	Logistics and Warehouse
Mechanic	Logistics and Warehouse
Purchasing	Logistics and Warehouse
Purchasing Manager	Logistics and Warehouse
Quality Manager	Logistics and Warehouse
Shipping	Logistics and Warehouse
Shipping Clerk	Logistics and Warehouse
Supervisor	Logistics and Warehouse
Supply Chain	Logistics and Warehouse
Team Leader	Logistics and Warehouse
Truck Driver	Logistics and Warehouse
Van Driver	Logistics and Warehouse
Warehouse	Logistics and Warehouse
Warehouse Associate	Logistics and Warehouse
Warehouse Clerk	Logistics and Warehouse
Warehouse Lead	Logistics and Warehouse
Warehouse Manager	Logistics and Warehouse
Warehouse Selector	Logistics and Warehouse
Warehouse Supervisor	Logistics and Warehouse
Warehouse Worker	Logistics and Warehouse
Aircraft Mechanic	Transportation
Aircraft Technician	Transportation
Auto Body Technician	Transportation
Automotive	Transportation
Automotive Service Manager	Transportation
Bus Driver	Transportation
Bus Operator	Transportation
Chauffeur	Transportation
Courier	Transportation
Delivery Driver	Transportation
Diesel Mechanic	Transportation
Diesel Technician	Transportation
Dispatcher	Transportation
Dock Worker	Transportation
Driver	Transportation
Driver Helper	Transportation
Driving	Transportation
First Officer	Transportation
Flatbed Driver	Transportation
Fleet Mechanic	Transportation
Forklift Driver	Transportation
Forklift Operator	Transportation
Helicopter Mechanic	Transportation
Inventory Clerk	Transportation
Inventory Specialist	Transportation
Laborer	Transportation
Lube Technician	Transportation
Machinist	Transportation
Material Planner	Transportation
Messenger	Transportation
Mover	Transportation
Operations Manager	Transportation
Order Picker	Transportation
Order Puller	Transportation
Order Selector	Transportation
Owner Operator	Transportation
Package Handler	Transportation
Pilot	Transportation
Production Planner	Transportation
Professional Driver	Transportation
Project Scheduler	Transportation
Records Clerk	Transportation
Regional Truck Driver	Transportation
Route Driver	Transportation
Runner	Transportation
Scheduler	Transportation
Shipping Clerk	Transportation
Shipping Manager	Transportation
Shuttle Driver	Transportation
Stock Clerk	Transportation
Superintendent	Transportation
Taxi Driver	Transportation
Terminal Manager	Transportation
Tire Technician	Transportation
Tractor Trailer Driver	Transportation
Traffic Coordinator	Transportation
Trailer Mechanic	Transportation
Transport Driver	Transportation
Transportation	Transportation
Transportation Manager	Transportation
Transportation Planner	Transportation
Truck Driver	Transportation
Truck Driving	Transportation
Truck Unloader	Transportation
Van Driver	Transportation
Warehouse Worker	Transportation
Yard Driver	Transportation
